 #####
 #   ###
##X# X #
# OO O #
# PX  ##
###X#O#
  #   #
  #####